11111111111
1E000000C01
1000000C001
1111C000001
1P000000001
11111111111