1111111111111111111111
1E000000C00000E000C001
1000000C001000000C0001
1111C000001111C0111101
1P00000000100000000001
1111111111111111111111
