11111111111
1E000000C01
100000C0001
1111C000001
1P00000C001
11111111111